|||||||||||
|v.f..w.s||
|.|||||||||
|.|||||||||
|e|||||||||
