||||||||||
||w...ss||
|||||.|.||
|.v..~.<||
||.||||f||
||e|||||||
